fp_int_id,cp_level,cp_r_citing_zero,cp_r_citing_nonzero,tr_citing,cp_r_cited_zero,cp_r_cited_nonzero,tr_cited
0,18,14,4,7,0,18,18
1,121,42,79,151,121,0,0
2,16,7,9,16,0,16,16
3,7,5,2,2,0,7,7
4,2,2,0,0,0,2,2
5,0,0,0,0,0,0,0
6,1,1,0,0,0,1,1
7,2,1,1,1,0,2,2
8,0,0,0,0,0,0,0
9,0,0,0,0,0,0,0
10,0,0,0,0,0,0,0
11,0,0,0,0,0,0,0
12,0,0,0,0,0,0,0
13,5,2,3,4,0,5,5
14,2,2,0,0,0,2,4
15,0,0,0,0,0,0,0
16,0,0,0,0,0,0,0
17,12,11,1,1,0,12,16
18,10,5,5,6,0,10,17
19,9,8,1,1,0,9,10
20,9,6,3,3,0,9,9
21,2,2,0,0,0,2,4
22,2,2,0,0,0,2,2
23,4,4,0,0,0,4,4
24,2,2,0,0,0,2,2
25,3,2,1,1,0,3,3
26,1,1,0,0,0,1,1
27,1,1,0,0,0,1,1
28,1,1,0,0,0,1,2
29,0,0,0,0,0,0,0
30,0,0,0,0,0,0,0
31,2,2,0,0,0,2,3
32,0,0,0,0,0,0,0
33,0,0,0,0,0,0,0
34,0,0,0,0,0,0,0
35,4,4,0,0,0,4,7
36,5,5,0,0,0,5,10
37,5,4,1,1,0,5,5
38,1,1,0,0,0,1,1
39,3,3,0,0,0,3,3
40,0,0,0,0,0,0,0
41,0,0,0,0,0,0,0
42,0,0,0,0,0,0,0
43,0,0,0,0,0,0,0
44,1,1,0,0,0,1,1
45,1,1,0,0,0,1,2
46,0,0,0,0,0,0,0
47,0,0,0,0,0,0,0
48,0,0,0,0,0,0,0
49,1,1,0,0,0,1,2
50,1,1,0,0,0,1,2
51,2,2,0,0,0,2,7
52,0,0,0,0,0,0,0
53,1,1,0,0,0,1,2
54,0,0,0,0,0,0,0
55,0,0,0,0,0,0,0
56,0,0,0,0,0,0,0
57,0,0,0,0,0,0,0
58,0,0,0,0,0,0,0
59,0,0,0,0,0,0,0
60,0,0,0,0,0,0,0
61,0,0,0,0,0,0,0
62,0,0,0,0,0,0,0
63,0,0,0,0,0,0,0
64,1,1,0,0,0,1,2
65,3,3,0,0,0,3,3
66,0,0,0,0,0,0,0
67,2,2,0,0,0,2,3
68,1,1,0,0,0,1,1
69,1,1,0,0,0,1,2
70,1,1,0,0,0,1,1
71,1,1,0,0,0,1,3
72,0,0,0,0,0,0,0
73,1,1,0,0,0,1,1
74,1,1,0,0,0,1,2
75,1,1,0,0,0,1,2
76,0,0,0,0,0,0,0
77,0,0,0,0,0,0,0
78,0,0,0,0,0,0,0
79,0,0,0,0,0,0,0
80,0,0,0,0,0,0,0
81,1,1,0,0,0,1,1
82,0,0,0,0,0,0,0
83,0,0,0,0,0,0,0
84,0,0,0,0,0,0,0
85,0,0,0,0,0,0,0
86,0,0,0,0,0,0,0
87,0,0,0,0,0,0,0
88,0,0,0,0,0,0,0
89,0,0,0,0,0,0,0
90,0,0,0,0,0,0,0
91,0,0,0,0,0,0,0
92,0,0,0,0,0,0,0
93,0,0,0,0,0,0,0
94,0,0,0,0,0,0,0
95,0,0,0,0,0,0,0
96,0,0,0,0,0,0,0
97,0,0,0,0,0,0,0
98,0,0,0,0,0,0,0
99,0,0,0,0,0,0,0
100,0,0,0,0,0,0,0
101,0,0,0,0,0,0,0
102,0,0,0,0,0,0,0
103,0,0,0,0,0,0,0
104,1,1,0,0,0,1,2
105,0,0,0,0,0,0,0
106,0,0,0,0,0,0,0
107,0,0,0,0,0,0,0
108,0,0,0,0,0,0,0
109,0,0,0,0,0,0,0
110,0,0,0,0,0,0,0
111,0,0,0,0,0,0,0
112,0,0,0,0,0,0,0
113,0,0,0,0,0,0,0
114,0,0,0,0,0,0,0
115,0,0,0,0,0,0,0
116,0,0,0,0,0,0,0
117,0,0,0,0,0,0,0
118,0,0,0,0,0,0,0
119,0,0,0,0,0,0,0
120,0,0,0,0,0,0,0
121,0,0,0,0,0,0,0
